v1|v1alpha1|buffer
oper|operatorframework|buffer
mem|memcache|buffer
ope|operator|buffer
memca|memcache|buffer
DOCKER|DOCKERHUB_USERNAME|around
mani|manifests|buffer
definition|definitions|around
CRD|CRDs|buffer
Genera|Generate|buffer
i|insinde|around
genera|generate|around
genera|generate|buffer
api|api_kind|around
strin|string|go
int|int32|go
opera|operator|around
s|sdk|around
nam|name|around
sd|sdk|around
oper|operator|around
project|project|around
nvim|nvim|around
|node_modules|file
e|extensions|file
confi|config|around
Mard|Markdown|around
e|error.log|file
|bpytop.conf|file
ples|please|around
dotfile|dotfiles|around
dir|directory|around
instl|install|around
home|homebrew|around
homebre|homebrew|around
scip|script|around
fi|fisher|around
op|opt|file
bas|bash|file
bin|bin|file